1111111111
1000011C11
100C00Z001
100ZE000C1
11100C1111
10000Z00Z1
1EZZ000C01
10P00CC001
1111111111
